Name,Volume,Ask Size,Ask Price,Bid Size,Bid Price,Last Price,Shares Matched,Shares Routed
ARKG,803609,3702,26.86,44,26.85,26.85,801952,1657
USHY,718529,22255,36.22,63296,36.21,36.22,379020,339509
IGV,677456,4406,82.07,2091,82.06,82.06,677050,406
VXX,654177,7788,11.96,7742,11.95,11.96,652877,1300
VHAI,471381,100,0.13,100,0.12,0.13,443317,28064
UVIX,460431,5100,6.95,902,6.94,6.94,451361,9070
FBTC,456573,580,53.88,863,53.86,53.89,451785,4788
NVDQ,368772,7000,4.10,12171,4.09,4.11,368771,1
UVXY,368098,100,27.26,513,27.25,27.27,359744,8354
IEFA,294034,6900,75.20,24600,75.19,75.20,290199,3835
INDA,232036,25685,52.15,16890,52.14,52.14,231930,106
BITX,210691,100,37.38,107,37.35,37.39,204206,6485
VIXY,191861,5400,11.88,1653,11.87,11.87,190141,1720
ITB,180378,400,108.08,3,108.07,108.07,175557,4821
COWZ,144664,1206,55.91,2493,55.90,55.90,144663,1
SVIX,132790,200,44.47,200,44.44,44.45,92461,40329
ARKB,129166,150,61.60,600,61.57,61.62,127490,1676
GOVT,126860,130450,22.42,176276,22.41,22.42,126725,135
EZU,112738,8005,52.29,4600,52.28,52.28,112528,210
CALF,102706,1500,46.88,22,46.87,46.88,101049,1657
QUAL,94659,100,163.70,451,163.68,163.72,94257,402
PAVE,85031,1600,39.25,1427,39.24,39.24,85031,0
AAAU,81140,54000,23.33,47663,23.32,23.32,81120,20
USMV,79645,1800,83.03,3300,83.02,83.02,79344,301
PICK,75117,1,44.55,112,44.46,44.48,75017,100
ICSH,71989,10276,50.42,14170,50.41,50.42,48485,23504
MTUM,68072,100,185.00,300,184.97,184.98,65403,2669
MOAT,63099,1790,88.87,1170,88.85,88.86,61208,1891
BBJP,62580,1700,56.15,1200,56.14,56.13,62580,0
EFV,57612,1201,55.98,1400,55.97,55.97,57610,2
CBOE,53803,18,180.75,2,180.71,180.72,53803,0
BUFR,50591,700,28.28,982,28.27,28.27,50591,0
SVXY,49321,200,58.50,300,58.48,58.48,48923,398
ECH,44936,200,28.81,10,28.78,28.79,44936,0
ITA,40833,804,134.78,200,134.77,134.77,40833,0
FLOT,40374,11387,50.98,5053,50.97,50.98,40368,6
NVDX,37522,1000,97.95,900,97.77,97.59,37522,0
REM,35945,10200,23.23,2072,23.22,23.21,35745,200
SING,34231,100,0.17,2000,0.17,0.17,33117,1114
SPYI,34231,386,49.67,500,49.66,49.67,34231,0
HEFA,31520,2400,35.70,1038,35.69,35.69,31520,0
IFRA,30888,400,44.40,135,44.39,44.36,24111,6777
CEFS,30010,300,20.61,289,20.51,20.53,30010,0
DFIC,29269,9814,27.19,32039,27.18,27.18,29269,0
HYD,29082,358,51.80,1306,51.79,51.80,28848,234
IDV,28473,1000,29.43,5100,29.42,29.42,28053,420
FBCG,27357,576,39.11,25,39.09,39.10,27357,0
RDVI,27002,700,23.94,100,23.92,23.93,26542,460
BOXX,26928,11521,107.13,2802,107.12,107.13,26928,0
VNM,26237,950,12.58,4242,12.57,12.58,26237,0
JBBB,25402,700,48.93,590,48.92,48.90,25313,89
JCPB,24957,1029,45.98,275,45.97,45.97,24957,0
DFIS,24419,1300,25.60,700,25.58,25.58,24419,0
NOBL,23295,1500,99.62,100,99.61,99.61,23292,3
SMIN,22950,235,73.72,1787,73.63,73.70,22581,369
ACWV,22760,204,105.11,25,105.08,105.10,22710,50
MLN,22152,3074,17.96,12660,17.95,17.96,21454,698
NDOW,22100,900,25.16,900,25.09,25.14,22100,0
IBHE,21631,1200,23.27,500,23.26,23.26,21631,0
ESGV,21010,700,92.81,119,92.79,92.73,21010,0
VIXM,20364,200,14.35,126,14.33,14.34,15971,4393
IYZ,20156,10800,21.76,101,21.75,21.73,20156,0
SMDV,20118,1600,65.07,900,65.02,65.04,20118,0
IAGG,19270,4119,49.69,226,49.68,49.68,19170,100
BBCA,19156,100,66.53,6,66.52,66.48,19096,60
DISV,18952,500,28.07,1572,28.06,28.07,18952,0
FLBL,18949,1000,24.41,400,24.39,24.40,18949,0
BAUG,18505,600,39.12,3200,39.07,39.05,18505,0
BBAX,18452,300,49.52,800,49.51,49.50,18452,0
BUFD,18262,749,23.87,424,23.86,23.86,17562,700
BBEU,17859,2500,61.31,1400,61.30,61.30,17638,221
ICOW,15837,4600,32.77,655,32.76,32.76,15437,400
OMFL,15608,1000,54.42,100,54.41,54.37,15598,10
JMST,15598,433,50.68,1300,50.67,50.68,15121,477
IYT,15192,1300,66.37,11,66.36,66.34,15192,0
EFAV,15159,348,71.70,600,71.69,71.68,15145,14
TLTW,15156,500,25.47,345,25.46,25.46,15153,3
BTCO,15070,300,61.64,100,61.60,61.62,14970,100
MEAR,14616,800,50.04,100,50.03,50.03,14616,0
EFG,13916,100,103.70,11,103.66,103.62,13916,0
BAPR,13848,400,40.19,3287,40.15,40.15,13848,0
LVHI,12838,600,30.55,24,30.54,30.54,9829,3009
ICVT,12700,300,78.70,185,78.66,78.65,12700,0
FFLG,12645,601,22.00,1100,21.95,21.95,10645,2000
XSHD,12501,510,15.19,2100,15.18,15.17,12500,1
HODL,12497,500,69.74,100,69.67,69.68,12497,0
KNG,12146,400,52.62,88,52.60,52.55,12146,0
EWUS,12103,100,36.49,100,36.36,36.39,12103,0
GCOW,11347,268,35.46,800,35.45,35.44,11271,76
IEO,11334,300,103.37,400,103.33,103.14,11334,0
EEMV,11175,80,57.45,455,57.44,57.44,10994,181
AAPR,11109,1000,24.78,1000,24.71,24.74,8916,2193
ARKQ,11097,200,55.81,1500,55.78,55.79,11097,0
EZBC,10919,800,35.78,1100,35.71,35.75,10919,0
CNYA,10916,500,27.08,48,27.07,27.07,10190,726
VUSB,10818,11276,49.41,1508,49.40,49.40,10248,570
BUFZ,10801,5000,22.47,6300,22.43,22.44,10801,0
PRNT,10581,742,21.24,400,21.07,21.15,10481,100
HSRT,10550,500,39.09,800,39.04,39.04,9750,800
IBHF,10266,1600,22.91,100,22.90,22.90,10266,0
PTLC,10068,700,47.79,100,47.76,47.75,7768,2300
DIHP,10065,2200,26.87,1900,26.86,26.86,8985,1080
IBMN,9768,130,26.45,1200,26.44,26.45,9768,0
VLUE,9729,201,104.00,400,103.98,103.98,9673,56
VTEC,9196,700,99.59,618,99.56,99.59,9196,0
ARKX,9086,35,15.57,1468,15.55,15.57,9081,5
NETZ,8967,400,70.24,1000,70.21,70.20,8967,0
HYXU,8819,700,49.02,700,48.86,49.01,8819,0
NUDM,8724,32,31.50,900,31.33,31.47,8724,0
DIVB,8106,628,44.36,2800,44.34,44.31,8101,5
ITM,8059,430,46.09,1400,46.08,46.10,8004,55
STOT,7746,50,46.74,500,46.72,46.72,7746,0
GSEP,7736,700,33.34,900,33.28,33.29,7736,0
HYBL,7716,600,28.24,636,28.21,28.21,7716,0
NULV,7555,500,38.37,900,38.36,38.35,7555,0
BMAY,7500,33,36.89,3000,36.87,36.75,7500,0
FMAY,7180,3400,43.68,2125,43.64,43.64,7180,0
NUMV,7148,31,33.89,200,33.88,33.88,7148,0
WTAI,7040,100,20.17,300,20.15,20.15,6840,200
GOVZ,6890,400,10.60,3100,10.59,10.60,6890,0
PAPR,6729,100,33.74,100,33.72,33.73,6729,0
FRDM,6684,494,35.28,100,35.19,35.28,6684,0
TMFG,6586,500,29.88,1300,29.83,29.77,6586,0
DDLS,6529,600,35.25,300,35.18,35.23,6529,0
FAUG,6524,500,43.36,500,43.30,43.30,6524,0
BUFQ,6394,400,28.69,200,28.63,28.65,6394,0
RSST,6347,600,24.02,200,23.95,23.96,6347,0
NEAR,6261,500,50.20,1953,50.19,50.20,6161,100
BTCW,6252,900,65.50,100,65.43,65.48,6252,0
IQDG,6227,602,37.79,1800,37.78,37.78,6227,0
IBHJ,6177,1000,25.83,207,25.82,25.80,6177,0
HYMU,6151,500,22.44,670,22.42,22.43,6151,0
SYLD,6091,300,70.55,209,70.52,70.43,6091,0
ACIO,5775,6100,36.22,100,36.17,36.18,5714,61
FLQM,5765,300,52.16,300,52.10,52.08,5765,0
QDTE,5701,1000,44.43,1,44.41,44.42,5521,180
BBUS,5477,200,94.57,100,94.56,94.52,4487,990
AESR,5469,300,15.54,300,15.52,15.52,5469,0
GVI,5441,400,103.10,400,103.09,103.11,4657,784
ICLO,5345,73,25.71,1010,25.70,25.71,5345,0
BUFT,5305,200,21.62,800,21.55,21.54,5305,0
FDRV,5304,100,14.67,1500,14.61,14.62,5304,0
FDEM,5213,41,25.85,600,25.74,25.79,5213,0
ICF,5180,625,56.24,3200,56.22,56.21,5082,98
EMHY,5179,300,37.35,900,37.33,37.33,4961,218
IMFL,5169,500,26.09,900,25.97,26.05,5169,0
IYLD,5157,101,20.03,500,20.01,20.02,5157,0
DDWM,5016,1000,35.09,1000,35.02,34.96,5016,0
TMFC,4946,300,49.94,400,49.93,49.93,4645,301
NUSC,4760,600,40.79,800,40.77,40.77,4760,0
JMUB,4532,200,50.50,600,50.49,50.50,4532,0
IETC,4454,200,69.78,614,69.75,69.72,4454,0
YBTC,4447,483,49.37,50,49.25,49.37,4447,0
XJH,4395,503,40.80,1008,40.72,40.70,4395,0
BUFG,4368,900,22.68,200,22.59,22.61,4368,0
IBMO,4359,700,25.28,1000,25.27,25.27,4359,0
VAMO,4317,300,29.48,899,29.39,29.37,4317,0
IBHG,4252,1100,22.04,414,22.01,22.03,4252,0
OUSA,4248,200,48.89,1000,48.87,48.84,4153,95
IBMP,4203,1312,25.03,1000,25.02,25.03,4203,0
SLVP,4104,441,12.28,500,12.22,12.22,4104,0
GMAR,4055,400,34.61,2200,34.54,34.59,4055,0
IZRL,3996,205,20.50,100,20.40,20.50,3955,41
TMFM,3937,2000,26.65,1800,26.62,26.53,3937,0
SEIV,3923,58,30.60,1000,30.59,30.57,3923,0
CEMB,3910,600,44.10,239,44.09,44.09,3910,0
FCLD,3860,96,24.17,500,24.16,24.15,3860,0
BUFB,3805,500,29.76,1500,29.65,29.66,3805,0
ESML,3749,200,39.65,100,39.63,39.58,3670,79
PSFM,3733,3000,27.14,3000,27.05,27.09,3733,0
RMIF,3723,900,25.19,3600,25.08,25.09,3723,0
GSST,3714,2829,50.23,100,50.22,50.22,3714,0
CLSE,3698,100,20.69,100,20.68,20.67,3367,331
TYA,3678,1300,12.79,200,12.77,12.79,3678,0
SMMV,3584,200,37.52,841,37.49,37.44,3584,0
NULG,3574,700,75.75,800,75.69,75.70,3574,0
BBRE,3558,300,86.56,300,86.51,86.48,3558,0
WLDR,3400,36,31.26,300,30.98,30.99,3400,0
PTMC,3344,200,35.83,300,35.80,35.74,3344,0
HYIN,3313,700,18.88,700,18.85,18.85,2013,1300
GOOX,3234,800,33.13,100,33.08,33.13,3234,0
NUMG,3211,400,43.37,900,43.32,43.18,3211,0
IBMM,3201,2250,25.98,1400,25.97,25.97,3201,0
JPIB,3149,70,47.21,3,47.15,47.21,3149,0
NANC,3093,29,34.32,10,34.30,34.32,3093,0
IYJ,3082,700,124.32,700,124.29,124.29,2682,400
FBCV,3055,100,30.89,1000,30.87,30.80,3055,0
HYDB,3031,1100,46.45,100,46.44,46.39,2945,86
OUSM,3029,100,42.16,1100,42.13,42.11,3029,0
MDLV,3000,748,25.52,900,25.47,25.51,3000,0
FLDR,2966,200,49.99,100,49.98,49.98,2966,0
VSGX,2898,165,58.00,250,57.93,57.95,2898,0
APRJ,2878,4200,24.76,200,24.71,24.74,2878,0
PFEB,2796,1026,34.45,3200,34.38,34.39,2796,0
VFQY,2732,600,134.77,1010,134.49,134.57,2732,0
IBHD,2728,601,23.22,521,23.21,23.22,2728,0
MAMB,2728,800,21.99,800,21.97,21.98,2723,5
PJUL,2718,626,38.40,900,38.34,38.38,2718,0
BAMY,2699,1000,26.91,900,26.88,26.91,2699,0
FFLC,2668,1400,42.12,142,42.09,42.09,2668,0
TOKE,2612,1,6.60,1,6.52,6.58,2612,0
VHAI+B,2601,100,17.06,100,14.00,14.10,2601,0
IDUB,2598,1000,21.22,1000,21.13,21.19,2598,0
IGEB,2567,1025,44.12,25,44.09,44.12,2567,0
VCEB,2523,600,61.80,100,61.73,61.80,2523,0
SEIQ,2501,1000,32.04,1000,32.01,31.99,2501,0
SMOT,2498,400,32.72,200,32.71,32.70,2498,0
GSUS,2455,2000,71.93,1400,71.90,71.88,2455,0
EYLD,2446,3200,35.54,20,35.48,35.49,2446,0
DINT,2409,1000,21.38,1400,21.26,21.33,2409,0
DFRA,2397,300,31.41,507,31.37,31.34,2397,0
JEMA,2396,500,38.22,1400,38.16,38.10,2396,0
GJAN,2394,63,36.17,200,36.09,36.11,2394,0
QSPT,2382,300,25.31,4200,25.25,25.31,2382,0
TTAI,2367,109,30.09,900,30.03,30.02,2367,0
GDEC,2327,400,31.87,3200,31.79,31.82,2327,0
SEIM,2327,1000,31.50,1000,31.46,31.45,1827,500
QJUN,2323,197,25.90,300,25.85,25.87,2323,0
UMAR,2300,700,32.77,400,32.69,32.70,2300,0
IBMQ,2297,800,25.12,100,25.09,25.11,2297,0
XTJA,2271,300,26.02,200,25.93,26.01,2271,0
SATO,2243,1000,12.61,1000,12.57,12.59,2243,0
DAUG,2240,34,37.37,500,37.36,37.35,2240,0
FLHY,2235,800,23.59,800,23.58,23.58,2235,0
FSEP,2212,400,42.95,3000,42.87,42.91,2212,0
ISPY,2210,400,42.41,4,42.28,42.35,2210,0
DUSA,2197,1,40.25,600,40.15,40.13,2197,0
BCHP,2157,1700,31.53,1500,31.51,31.49,2157,0
BINV,2137,1000,31.14,2000,31.04,31.04,2137,0
XMPT,2130,400,21.37,100,21.33,21.35,2130,0
VFVA,2114,100,117.29,500,117.22,117.20,2114,0
PMAY,2086,50,33.39,3000,33.37,33.36,2086,0
QTAP,2041,400,33.08,200,32.97,32.97,841,1200
DSCF,2020,500,22.41,500,22.37,22.37,1420,600
TRTY,2018,899,26.18,1,26.06,26.16,2018,0
FDVL,2012,200,11.76,1300,11.74,11.74,2012,0
JPLD,2005,28,50.84,900,50.79,50.81,2005,0
PSFF,2004,3000,27.23,4000,27.15,27.22,2004,0
APRH,2001,4000,24.76,4200,24.69,24.75,2001,0
FJUN,1991,400,47.62,700,47.51,47.49,1991,0
VFMO,1978,700,149.36,700,149.11,149.30,1978,0
FMAR,1965,800,39.44,500,39.38,39.41,1965,0
ZALT,1964,900,27.55,700,27.49,27.53,1964,0
BBHY,1961,1000,45.71,100,45.70,45.71,1961,0
FRNW,1944,1425,15.58,500,15.50,15.48,1943,1
FCPI,1933,1800,39.45,1908,39.41,39.42,1908,25
FJUL,1917,100,44.92,3200,44.88,44.79,1917,0
XVV,1916,600,40.26,600,40.17,40.12,1916,0
FMAG,1896,1000,27.99,1100,27.96,27.96,1263,633
FYLD,1879,600,27.92,300,27.80,27.88,1879,0
BBIN,1867,300,60.99,818,60.87,60.81,1867,0
EFUT,1835,200,23.83,200,23.78,23.77,735,1100
XMAR,1789,3400,33.94,3041,33.85,33.91,1789,0
GSEW,1783,300,71.78,1200,71.74,71.70,1783,0
GAPR,1772,400,34.90,2200,34.80,34.79,1772,0
UMAY,1767,3400,31.16,3500,31.09,31.10,267,1500
TAIL,1751,200,11.77,305,11.75,11.76,1751,0
POCT,1746,300,37.88,700,37.83,37.85,1496,250
KAPR,1695,400,30.99,200,30.89,30.93,1695,0
IAUF,1681,1600,62.10,22,61.78,61.95,1680,1
VXZ,1629,800,12.45,75,12.42,12.42,1229,400
VOTE,1617,1300,61.26,400,61.25,61.24,1617,0
NJUL,1608,400,58.60,200,58.42,58.50,1608,0
SECT,1578,1000,50.46,1000,50.41,50.37,1578,0
BALI,1563,500,28.60,502,28.52,28.58,1563,0
IGHG,1561,700,76.71,13,76.68,76.67,1561,0
EPRF,1538,300,18.67,400,18.61,18.66,1538,0
HAUS,1516,2900,17.24,2900,17.21,17.24,1516,0
UAPR,1513,900,28.22,200,28.17,28.19,1213,300
EMGF,1504,152,46.95,300,46.92,46.95,1504,0
GJUL,1490,700,34.22,900,34.16,34.16,1490,0
PAUG,1486,3700,35.78,200,35.70,35.71,1486,0
IGRO,1471,100,68.03,78,67.93,68.02,1471,0
DMAY,1455,3500,37.60,3306,37.52,37.59,1455,0
PAWZ,1453,59,51.19,300,51.05,51.10,1453,0
SMMD,1442,800,64.61,900,64.54,64.47,1442,0
PJAN,1441,600,39.44,3011,39.37,39.36,1441,0
MPRO,1428,100,27.55,800,27.53,27.51,1428,0
OSCV,1416,100,35.29,200,35.20,35.19,1324,92
KJUL,1401,100,28.04,300,27.98,27.94,1401,0
XTAP,1400,400,31.26,300,31.15,31.16,1400,0
MSFY,1378,2999,27.77,300,27.66,27.77,1378,0
ROMO,1372,1700,28.95,456,28.90,28.88,1372,0
AAPX,1371,550,23.97,850,23.91,23.95,1371,0
AFIF,1337,100,9.13,4500,9.11,9.12,1337,0
BGLD,1325,100,20.34,100,20.21,20.35,1325,0
BAMD,1324,900,29.62,800,29.59,29.59,1046,278
XDAT,1318,235,22.10,625,22.07,22.07,1318,0
SHYD,1316,79,22.40,200,22.35,22.38,1316,0
FFSM,1304,1125,25.93,25,25.92,25.84,1304,0
NUEM,1300,400,28.61,400,28.29,28.30,1300,0
DMAR,1272,600,35.02,200,34.95,34.98,1272,0
KRUZ,1269,2500,30.00,2517,29.89,29.91,869,400
OILK,1261,800,46.25,1800,46.19,46.20,1261,0
XDQQ,1228,200,28.87,3000,28.80,28.61,1228,0
IBHH,1216,200,23.09,1000,23.07,23.08,1216,0
SVAL,1195,2218,30.22,2100,30.18,30.14,1195,0
XSEP,1184,900,37.42,200,37.31,37.37,1184,0
BUYW,1173,100,13.77,400,13.74,13.76,1173,0
BUFF,1143,300,42.10,126,42.03,42.09,1143,0
GFEB,1141,494,34.63,900,34.54,34.54,1141,0
JANQ,1123,900,24.77,1000,24.73,24.77,1123,0
WEED,1109,300,42.69,300,42.16,42.00,1109,0
ATMP,1100,2400,24.81,2200,24.77,24.60,1100,0
MSMR,1094,8906,27.28,9094,27.19,27.25,1094,0
NAPR,1075,400,45.88,300,45.73,45.81,1075,0
REGL,1074,400,77.70,300,77.65,77.57,978,96
GDE,1051,200,33.21,100,33.01,33.21,1051,0
SMB,1045,900,17.00,1700,16.99,17.00,1045,0
ARKZ,1016,500,34.41,500,34.36,34.05,1016,0
NOCT,1016,500,48.22,800,48.09,48.11,1016,0
SMAY,1014,900,23.22,1200,23.17,23.14,1014,0
APRQ,1011,4200,24.71,4000,24.61,24.70,1011,0
MBCC,1005,500,31.78,500,31.75,31.74,505,500
MSTB,1004,2600,31.16,2500,31.03,31.05,1004,0
BAMU,1001,1100,25.43,700,25.40,25.40,1001,0
BBEM,1000,500,52.55,1000,52.50,52.42,1000,0
XDTE,997,1000,52.06,1000,51.88,52.03,997,0
TDV,985,900,72.40,700,72.33,72.30,985,0
IBMR,979,700,24.98,100,24.96,24.98,979,0
UAUG,964,2400,33.00,3200,32.92,32.91,964,0
JULJ,950,100,25.07,50,25.04,25.04,950,0
LQDI,925,1500,25.76,658,25.71,25.74,925,0
XDEC,917,600,35.63,200,35.52,35.58,917,0
KJAN,915,500,35.23,3000,35.17,35.20,915,0
RULE,908,700,21.66,431,21.62,21.61,908,0
VFMV,908,600,112.08,22,111.80,111.97,908,0
PSMR,900,3000,25.67,3000,25.59,25.59,0,900
PDEC,889,500,36.92,3700,36.85,36.88,889,0
BALT,835,200,29.37,200,29.36,29.37,835,0
SFIG,820,100,47.61,700,47.56,47.58,820,0
QCAP,819,1200,20.61,1000,20.55,20.60,819,0
MSFX,817,60,28.18,2000,28.12,28.16,817,0
FLQL,813,300,52.97,200,52.95,52.93,717,96
VEGN,808,8000,45.99,8400,45.92,45.87,808,0
SFEB,807,400,20.28,300,20.21,20.24,807,0
IGE,802,1500,45.59,174,45.58,45.34,802,0
FPRO,791,900,20.37,900,20.34,20.35,791,0
INAV,791,1700,26.25,909,26.20,26.17,791,0
DRSK,790,300,26.44,197,26.41,26.43,790,0
LQDW,787,200,28.23,376,28.22,28.23,787,0
FNOV,781,400,45.16,400,45.06,45.08,781,0
MARM,780,500,29.23,3511,29.20,29.22,780,0
FDEV,750,59,27.85,978,27.79,27.82,750,0
DSEP,747,500,38.58,3200,38.50,38.51,747,0
PBUS,744,2300,52.45,1700,52.44,52.41,744,0
USMF,744,2500,45.70,1500,45.61,45.58,744,0
JCPI,734,600,46.38,100,46.35,46.16,734,0
DDEC,732,400,37.77,300,37.68,37.69,732,0
RSBT,723,100,18.38,100,18.30,18.37,723,0
DOCT,720,400,38.02,200,37.93,37.92,720,0
GMAY,717,1684,34.30,500,34.23,34.30,717,0
ADME,716,6000,41.95,6000,41.86,41.76,716,0
HEEM,716,1000,26.97,1100,26.90,26.90,716,0
XJR,710,500,39.27,1100,39.16,39.17,710,0
SHAG,702,200,46.98,600,46.91,46.94,702,0
WFHY,702,1000,44.91,700,44.87,44.87,702,0
OBND,701,700,25.73,107,25.68,25.72,701,0
MDPL,700,700,25.84,700,25.81,25.86,700,0
XSHQ,700,1400,40.63,1100,40.52,40.43,700,0
PSEP,694,667,36.92,300,36.84,36.86,694,0
JANJ,692,1000,24.88,1000,24.84,24.83,692,0
YDEC,691,400,23.84,200,23.73,23.74,691,0
TJUL,685,1400,26.45,1000,26.37,26.42,685,0
TGLR,682,1800,27.09,1800,27.01,27.01,682,0
GMOM,681,22,28.82,300,28.71,28.75,681,0
FDEC,678,600,41.59,700,41.50,41.50,678,0
NJAN,664,100,43.94,3000,43.87,43.92,664,0
QMAR,655,400,26.76,200,26.69,26.70,655,0
IBHI,629,1000,23.08,1000,23.03,23.05,629,0
OGIG,614,500,38.60,150,38.54,38.53,614,0
JULD,612,1000,25.17,388,25.14,25.14,612,0
MAYU,612,400,25.82,200,25.76,25.71,612,0
QVOY,609,900,28.14,900,28.11,28.09,609,0
XJUL,609,400,33.60,1200,33.50,33.51,609,0
FLQS,606,200,39.97,200,39.91,39.90,606,0
RPHS,600,900,9.68,900,9.63,9.61,600,0
DWLD,596,500,34.73,500,34.61,34.58,596,0
GOOP,591,3000,30.56,1,30.44,30.61,591,0
PMAR,590,1600,37.05,900,36.99,36.96,590,0
TMFS,582,1600,31.41,1600,31.35,31.37,385,197
VFMF,580,600,125.30,701,125.04,125.09,580,0
FCTR,556,1100,31.01,1100,30.93,30.87,556,0
VTEI,554,700,99.65,800,99.64,99.65,554,0
GDMN,549,200,29.46,2800,29.25,29.01,549,0
BFEB,535,400,39.62,3000,39.54,39.49,535,0
FUNL,505,500,39.00,500,38.87,38.90,505,0
GJUN,502,1800,33.77,200,33.68,33.66,502,0
FDND,501,500,20.06,1800,19.96,20.17,501,0
SDVD,501,100,21.70,600,21.69,21.69,501,0
HJAN,500,4000,24.78,4200,24.69,24.71,500,0
JANH,500,1000,25.01,1000,24.97,24.96,500,0
GHYG,496,100,43.78,200,43.69,43.76,496,0
BUSA,483,2500,30.20,2500,30.16,30.17,483,0
MFUL,481,200,21.25,419,21.22,21.22,481,0
EDEN,480,600,126.44,300,126.00,126.22,480,0
PBTP,479,1300,25.20,900,25.17,25.18,479,0
YJUN,464,400,22.41,400,22.31,22.32,464,0
DFNL,454,900,33.93,300,33.86,33.76,454,0
DUBS,454,500,29.32,600,29.23,29.30,454,0
BSMC,450,1000,29.82,1000,29.71,29.65,450,0
MOTI,439,900,33.11,1600,32.89,32.98,439,0
LKOR,432,600,42.43,700,42.35,42.36,432,0
ARKY,430,500,35.78,1,35.72,35.66,430,0
STLG,425,300,47.97,1100,47.92,47.94,425,0
TILT,423,200,197.52,200,197.40,197.35,423,0
PIT,412,300,49.38,300,49.25,49.21,412,0
UJAN,409,72,36.34,3200,36.28,36.32,409,0
HEGD,408,700,20.64,1,20.62,20.61,408,0
LEAD,403,800,64.00,800,63.94,63.89,403,0
ARLU,400,400,24.99,200,24.91,24.90,400,0
XBJA,400,250,27.25,3000,27.17,27.18,400,0
PJUN,391,2900,34.89,700,34.77,34.80,391,0
KOCT,389,400,28.60,300,28.50,28.52,389,0
DFEB,381,3500,39.33,4800,39.24,39.20,381,0
XBAP,381,3000,31.48,51,31.44,31.44,381,0
HELX,364,1700,31.69,800,31.62,31.64,364,0
GEMD,354,500,40.57,500,40.53,40.49,354,0
HCRB,352,800,34.54,200,34.48,34.48,352,0
OMFS,349,200,37.63,600,37.50,37.42,255,94
SNAV,340,1700,29.20,561,29.14,29.10,340,0
BDEC,335,400,40.97,3000,40.89,40.89,335,0
FOCT,329,25,40.95,300,40.92,40.95,329,0
AMZP,324,3000,31.70,300,31.62,31.67,324,0
GDMA,323,900,30.94,709,30.87,30.87,323,0
HYHG,323,400,64.15,2,64.02,64.10,323,0
BRLN,321,1000,52.81,19,52.65,52.65,321,0
FPFD,313,1000,21.38,50,21.34,21.38,313,0
TSLP,306,300,20.21,5000,20.06,20.01,306,0
RSSB,304,1108,22.24,1000,22.17,22.20,304,0
EALT,302,900,28.98,600,28.91,28.94,302,0
EFAD,302,200,38.89,500,38.78,38.75,302,0
PNOV,300,200,35.93,700,35.87,35.91,300,0
XIDE,300,200,30.40,200,30.31,30.37,300,0
DJUL,293,1300,39.11,3200,39.05,39.03,293,0
OCTH,292,3200,24.37,3200,24.27,24.26,292,0
JULZ,284,3000,39.20,3000,39.11,39.14,284,0
FJAN,277,400,42.38,425,42.29,42.25,277,0
TTAC,277,1000,59.81,800,59.70,59.77,277,0
XDSQ,276,3000,31.47,3000,31.39,31.23,276,0
BJAN,274,461,43.91,3000,43.84,43.78,274,0
GVAL,264,80,22.80,300,22.66,22.71,264,0
UNOV,248,400,33.02,400,32.92,32.98,248,0
DECZ,246,3000,34.40,100,34.31,34.37,246,0
DFHY,235,900,21.00,665,20.95,20.95,235,0
NOVZ,232,3000,37.67,3000,37.58,37.60,32,200
TMAT,217,300,16.96,200,16.94,16.93,217,0
IVRA,206,225,14.17,1000,14.13,14.13,206,0
UJUL,203,1300,32.24,1000,32.14,32.15,203,0
BAMB,201,1100,25.68,800,25.65,25.65,201,0
RYSE,201,600,25.41,700,25.37,25.43,201,0
TOLL,201,200,31.57,200,31.45,31.37,201,0
ARCM,200,1000,100.38,1000,100.27,100.26,200,0
JANP,200,3000,26.67,3000,26.59,26.56,200,0
PSFD,200,3000,30.78,3000,30.69,30.77,200,0
QDEC,200,4400,25.13,6700,25.05,24.99,200,0
XTJL,200,200,31.19,200,31.06,31.07,200,0
DOGG,196,500,20.97,200,20.90,20.85,196,0
MOTG,194,1000,36.67,500,36.62,36.61,194,0
DURA,188,300,32.25,100,32.23,32.13,188,0
XAPR,188,400,30.54,1500,30.47,30.48,188,0
CSM,187,1500,60.02,1500,59.82,59.83,119,68
GAA,187,100,28.73,1,28.70,28.72,187,0
YMAR,183,200,23.40,200,23.29,23.33,183,0
FLIA,177,700,20.09,261,20.08,20.08,177,0
FFEB,174,400,45.54,3000,45.46,45.33,174,0
GHTA,173,900,27.98,730,27.92,27.91,173,0
JANZ,172,3000,32.18,3006,32.05,32.03,172,0
TFJL,172,300,19.80,2200,19.73,19.71,172,0
NURE,164,100,30.55,2800,30.52,30.54,164,0
JUCY,161,700,23.35,500,23.29,23.30,161,0
IEDI,155,100,47.92,900,47.89,47.85,155,0
DAPR,154,600,34.49,400,34.40,34.43,154,0
GLOV,154,300,46.47,500,46.31,46.33,154,0
XFEB,154,400,30.81,1700,30.74,30.79,154,0
MBND,153,700,27.47,500,27.42,27.42,153,0
NULC,151,600,42.59,1000,42.56,42.57,151,0
KNOW,150,200,10.54,200,10.43,10.49,150,0
DJUN,146,80,40.47,500,40.39,40.43,146,0
BEMB,142,700,51.82,500,51.75,51.83,142,0
FDHT,140,500,18.90,500,18.81,18.78,140,0
JAND,140,1500,25.15,1500,25.11,25.09,140,0
WUGI,134,43,62.25,1000,62.10,61.86,134,0
PTEU,130,300,27.36,300,27.24,27.31,130,0
IQM,125,600,58.14,600,57.93,58.08,125,0
GAUG,124,3400,33.32,3200,33.22,33.25,124,0
PSFO,124,200,27.33,200,27.28,27.30,124,0
BBLB,123,900,86.51,900,86.43,86.36,123,0
IVVM,121,500,28.05,500,27.98,27.96,121,0
GTIP,109,700,48.34,600,48.29,48.27,109,0
ZECP,109,1700,28.24,1814,28.21,28.22,109,0
FDGR,108,1100,11.95,1400,11.92,11.94,100,8
WBAT,108,100,29.14,100,29.06,29.05,108,0
DNOV,103,500,40.75,700,40.68,40.70,103,0
FDCE,103,200,11.76,1400,11.73,11.72,103,0
BLDG,102,100,24.42,3500,24.37,24.41,102,0
EMDV,102,200,45.08,200,44.87,45.03,102,0
ESG,102,500,125.39,500,125.28,124.85,102,0
ISVL,102,250,36.19,250,36.07,36.05,102,0
ADFI,101,400,8.49,500,8.46,8.47,101,0
LCF,101,100,32.80,900,32.75,32.79,101,0
SEPZ,101,100,36.04,3000,36.02,36.02,101,0
TBJL,101,300,19.78,300,19.70,19.67,101,0
AUGZ,100,3000,36.73,3000,36.64,36.57,100,0
BAMA,100,800,28.66,800,28.63,28.62,100,0
BMAR,100,400,41.87,500,41.78,41.69,100,0
CVAR,100,800,25.68,900,25.61,25.58,100,0
FHEQ,100,1000,25.05,1000,25.01,25.03,100,0
FYEE,100,1000,25.18,1000,25.10,25.13,100,0
HIYS,100,900,25.44,900,25.37,25.43,100,0
JULH,100,1400,25.12,900,25.07,25.07,100,0
SPMV,100,100,43.02,500,42.93,42.79,100,0
VHAI+A,100,100,4.99,3,2.00,2.89,100,0
XIMR,100,1200,31.06,1200,30.96,31.02,100,0
XTOC,100,300,28.05,300,27.93,27.94,100,0
XUSP,100,500,34.91,500,34.80,34.64,100,0
HYGW,98,225,32.88,55,32.85,32.86,98,0
OEUR,98,500,30.70,600,30.61,30.60,98,0
AJAN,96,800,24.95,200,24.87,24.93,96,0
ENOR,95,300,25.08,44,24.99,25.00,95,0
PBP,95,200,22.29,55,22.24,22.25,95,0
UOCT,91,3600,33.93,3200,33.85,33.84,91,0
IGLD,86,100,20.25,9,20.20,20.24,86,0
HOCT,83,1000,24.11,629,24.06,24.06,83,0
XBJL,83,3000,32.05,3000,31.95,31.97,83,0
XJUN,83,78,36.54,3200,36.49,36.49,83,0
UFEB,82,1000,31.02,3200,30.94,30.91,82,0
SUPP,81,1000,64.31,1000,64.28,64.18,81,0
XDJA,80,3100,26.56,3000,26.47,26.47,80,0
USEP,77,400,33.29,600,33.20,33.21,77,0
EMTL,76,800,42.11,800,42.05,42.09,76,0
MDEV,71,100,20.88,1000,20.82,20.77,71,0
DJAN,70,500,36.32,700,36.24,36.23,70,0
APRD,61,5200,24.77,4200,24.69,24.72,61,0
PEX,60,500,30.50,500,30.35,29.90,60,0
BAMG,57,8,29.91,800,29.90,29.90,57,0
PWS,53,600,28.76,500,28.74,28.72,53,0
SAUG,53,400,21.95,300,21.88,21.87,53,0
MARZ,52,8,30.03,3000,30.01,29.98,52,0
BSEP,51,400,39.66,900,39.55,39.47,51,0
QUVU,51,100,24.83,600,24.75,24.69,51,0
OCTJ,49,3200,24.25,3200,24.15,24.19,5,44
MAYP,40,3000,25.68,1000,25.61,25.61,40,0
BLKC,38,300,18.90,300,18.82,18.83,38,0
FEBZ,37,3000,32.72,3000,32.63,32.66,0,37
EUDV,36,200,49.11,64,49.00,49.00,36,0
XJAN,33,400,32.05,1200,31.96,31.99,33,0
IVVW,32,800,49.13,1,49.03,49.10,32,0
QLC,32,500,59.06,500,59.01,58.81,32,0
ZIVB,30,300,24.39,400,24.31,24.02,30,0
BOCT,29,3400,40.94,3000,40.86,40.86,29,0
BJUL,28,1300,40.81,1000,40.70,40.66,28,0
FFOG,27,600,33.60,600,33.55,33.26,27,0
GOLY,25,875,22.46,125,22.35,22.45,25,0
MVFD,23,800,25.55,800,25.52,25.51,23,0
MVFG,22,1200,25.92,1200,25.89,25.90,22,0
EFNL,20,100,38.03,100,37.91,37.92,20,0
XEMD,14,700,41.28,1502,41.22,41.22,14,0
BNOV,12,300,36.86,700,36.78,36.77,12,0
ARKA,11,500,58.82,500,58.72,58.70,11,0
IPPP,11,100,9.89,100,9.82,8.88,11,0
KWT,11,100,33.61,200,33.56,33.53,11,0
HFGO,10,500,19.35,500,19.32,19.22,10,0
RSEE,10,3000,28.86,2990,28.81,28.69,10,0
VMAX,10,100,46.76,100,46.70,46.67,10,0
DFND,9,50,40.48,71,39.10,39.10,9,0
SNPG,9,700,38.94,700,38.80,38.54,9,0
XAUG,9,1000,32.61,1200,32.53,32.53,9,0
GSID,8,500,57.59,1000,57.33,57.37,8,0
WDNA,8,100,16.50,1200,16.43,16.60,8,0
NFLP,7,3300,30.94,3000,30.79,30.90,7,0
AAPY,6,4300,25.28,4000,25.13,25.27,6,0
BAMV,6,800,29.90,800,29.87,29.86,6,0
EAOA,6,300,34.13,300,34.10,33.90,6,0
RDFI,6,2995,22.74,3000,22.67,22.70,6,0
ROYA,5,600,27.09,900,26.99,27.02,5,0
ARKC,3,500,38.65,500,38.56,38.55,3,0
CFCV,3,900,36.52,900,36.42,36.75,3,0
EGUS,3,800,37.53,800,37.51,37.51,3,0
IPDP,3,12000,18.46,12000,18.38,18.61,3,0
MAYZ,3,3000,28.07,3000,27.99,27.99,3,0
MGRO,3,500,29.10,500,29.07,29.09,3,0
NXTI,3,800,25.48,800,25.44,25.34,3,0
QPFF,3,100,36.18,100,36.10,36.20,3,0
CMCI,2,100,26.01,100,25.84,25.97,2,0
ESGG,2,200,163.20,200,162.71,162.45,2,0
FFLV,2,1000,21.05,1000,21.00,21.05,2,0
FIBR,2,600,85.56,500,85.44,85.53,2,0
IWMW,2,400,47.96,500,47.91,47.93,2,0
MAGA,2,300,45.60,305,45.51,45.53,2,0
PSH,2,500,50.28,500,50.25,50.22,2,0
QCON,2,600,42.51,700,42.44,42.43,2,0
TSLH,2,4000,23.41,4000,23.33,23.35,2,0
XISE,2,300,30.55,200,30.46,30.46,2,0
ACSI,1,4500,53.58,4500,53.53,53.37,1,0
BJUN,1,900,38.05,200,37.95,37.99,1,0
BKGI,1,300,30.28,300,30.19,30.14,1,0
CAOS,1,5500,84.16,84,84.06,84.08,1,0
DWAT,1,1300,10.85,1000,10.83,10.84,1,0
EVUS,1,300,27.61,1100,27.60,27.58,1,0
FDTB,1,500,9.61,1100,9.58,9.61,1,0
HSUN,1,700,33.80,700,33.71,33.75,1,0
INTL,1,515,23.27,1000,23.23,23.23,1,0
IVVB,1,500,27.65,500,27.59,27.54,1,0
LBO,1,700,29.29,700,29.17,28.96,1,0
MOHR,1,1900,21.71,1700,21.66,21.59,1,0
MRGR,1,501,40.09,500,39.98,39.98,1,0
PSDM,1,701,50.47,100,50.42,50.42,1,0
PUTD,1,1000,22.50,100,22.39,22.49,1,0
SMI,1,700,46.04,700,45.96,46.03,1,0
TMDV,1,500,47.75,1000,47.70,47.89,1,0
TUSI,1,800,25.31,1100,25.28,25.30,1,0
XBOC,1,62,29.00,3000,28.94,28.97,1,0
APRP,0,3000,25.14,200,25.09,0.00,0,0
APRZ,0,100,32.20,3000,32.17,0.00,0,0
ARKD,0,100,39.50,100,39.27,0.00,0,0
AUGP,0,3000,25.11,3000,25.06,0.00,0,0
BAMO,0,100,28.43,800,28.41,0.00,0,0
BBIB,0,700,95.81,700,95.76,0.00,0,0
BBIP,0,200,96.96,200,96.89,0.00,0,0
BBSA,0,500,47.31,700,47.24,0.00,0,0
BBSB,0,200,97.63,200,97.55,0.00,0,0
BHYB,0,900,53.46,900,53.39,0.00,0,0
BUYZ,0,800,30.76,800,30.66,0.00,0,0
BWTG,0,1500,31.50,1500,31.43,0.00,0,0
DFNV,0,1600,30.03,1600,30.00,0.00,0,0
DWCR,0,900,31.75,900,31.52,0.00,0,0
EAOK,0,300,25.05,300,25.03,0.00,0,0
EAOM,0,300,26.82,300,26.79,0.00,0,0
EAOR,0,300,30.29,300,30.26,0.00,0,0
FAIL,0,1200,16.87,46,16.48,0.00,0,0
FAPR,0,400,37.99,350,37.91,0.00,0,0
FBUF,0,1000,25.03,1000,24.94,0.00,0,0
FEBP,0,3000,26.30,3000,26.22,0.00,0,0
FLDZ,0,6500,25.97,6000,25.89,0.00,0,0
FPAG,0,300,29.57,12,29.50,0.00,0,0
GCLN,0,200,35.03,200,34.79,0.00,0,0
GHEE,0,100,26.36,100,26.23,0.00,0,0
GHMS,0,100,25.60,100,25.52,0.00,0,0
GNOV,0,500,33.28,200,33.18,0.00,0,0
GOCT,0,3000,33.77,3200,33.71,0.00,0,0
GPOW,0,900,46.11,300,46.03,0.00,0,0
GSEE,0,100,45.13,1000,44.88,0.00,0,0
HAPR,0,700,25.03,700,24.97,0.00,0,0
HEAT,0,1000,26.15,1000,26.04,0.00,0,0
HYKE,0,700,29.68,700,29.60,0.00,0,0
IMSI,0,700,51.25,700,51.11,0.00,0,0
ISDB,0,700,24.84,600,24.80,0.00,0,0
JULP,0,3000,25.13,1000,25.07,0.00,0,0
JULQ,0,1100,25.01,1000,24.98,0.00,0,0
JUNZ,0,3000,28.36,3000,28.28,0.00,0,0
LAPR,0,700,25.04,716,24.98,0.00,0,0
LJAN,0,4000,24.70,4200,24.61,0.00,0,0
LOCT,0,700,24.01,700,23.97,0.00,0,0
MBBB,0,700,21.01,700,20.96,0.00,0,0
MBNE,0,20,29.74,200,29.59,0.00,0,0
MIG,0,900,20.95,600,20.89,0.00,0,0
MINN,0,1000,22.05,1,21.98,0.00,0,0
MOTE,0,800,26.38,800,26.35,0.00,0,0
MRCP,0,4000,25.64,1000,25.62,0.00,0,0
MSSS,0,1800,25.15,1800,25.12,0.00,0,0
MSTQ,0,2500,30.28,2500,30.16,0.00,0,0
MSVX,0,100,23.69,900,23.59,0.00,0,0
MVAL,0,500,30.64,500,30.60,0.00,0,0
MYLD,0,1500,26.64,1200,26.59,0.00,0,0
NUDV,0,400,27.28,1200,27.26,0.00,0,0
NXTV,0,801,25.84,800,25.81,0.00,0,0
OCTD,0,3200,24.50,3200,24.41,0.00,0,0
OCTQ,0,3000,24.15,3200,24.06,0.00,0,0
OCTZ,0,3000,36.14,3000,36.05,0.00,0,0
PBAP,0,3000,25.16,3000,25.07,0.00,0,0
PBAU,0,3000,25.11,3000,25.06,0.00,0,0
PBFB,0,3000,26.01,3200,25.92,0.00,0,0
PBJA,0,3000,26.27,7000,26.18,0.00,0,0
PBJL,0,3000,25.12,1000,25.06,0.00,0,0
PBL,0,400,27.52,400,27.35,0.00,0,0
PBMR,0,4000,25.56,1000,25.51,0.00,0,0
PBMY,0,3000,25.53,1000,25.46,0.00,0,0
PJBF,0,1000,57.68,1000,57.50,0.00,0,0
PJFM,0,500,52.54,500,52.48,0.00,0,0
PSCJ,0,200,24.83,200,24.78,0.00,0,0
PSCQ,0,105,25.34,200,25.32,0.00,0,0
PSCW,0,7,23.90,3000,23.83,0.00,0,0
PSCX,0,5,25.83,3000,25.79,0.00,0,0
PSFJ,0,5,27.02,200,26.97,0.00,0,0
PSMD,0,3000,27.29,3000,27.25,0.00,0,0
PSMJ,0,205,26.55,200,26.49,0.00,0,0
PSMO,0,200,26.43,200,26.37,0.00,0,0
QTJA,0,1000,22.87,1000,22.79,0.00,0,0
QTJL,0,400,29.89,200,29.78,0.00,0,0
QTOC,0,200,27.13,200,27.03,0.00,0,0
RODE,0,200,28.52,200,28.42,0.00,0,0
ROIS,0,1000,51.60,1000,51.33,0.00,0,0
RTAI,0,2400,20.79,2400,20.71,0.00,0,0
RVRB,0,1800,27.41,1800,27.38,0.00,0,0
SCLZ,0,500,51.10,400,50.96,0.00,0,0
SELV,0,78,27.23,1000,27.22,0.00,0,0
SHDG,0,100,26.39,100,26.31,0.00,0,0
SNOV,0,1400,21.85,1000,21.78,0.00,0,0
SNPD,0,700,26.55,700,26.46,0.00,0,0
SNPV,0,700,30.40,700,30.29,0.00,0,0
SPCZ,0,900,26.52,900,26.22,0.00,0,0
STBF,0,1000,25.10,1200,25.08,0.00,0,0
TDVI,0,500,22.96,500,22.90,0.00,0,0
TYLD,0,100,25.33,199,25.30,0.00,0,0
UDEC,0,400,33.72,3200,33.64,0.00,0,0
UJUN,0,1300,31.29,800,31.20,0.00,0,0
VIRS,0,500,35.77,500,35.63,0.00,0,0
VWID,0,500,27.84,1000,27.82,0.00,0,0
WFIG,0,700,43.84,700,43.76,0.00,0,0
XDAP,0,3000,31.80,3100,31.71,0.00,0,0
XDJL,0,3000,32.02,3000,31.93,0.00,0,0
XDOC,0,3100,28.85,3000,28.76,0.00,0,0
XNOV,0,3400,32.73,3000,32.65,0.00,0,0
XOCT,0,1500,33.14,1200,33.04,0.00,0,0
XVOL,0,900,20.46,900,20.26,0.00,0,0
YSEP,0,400,21.91,200,21.83,0.00,0,0